               #########   #########
               #.......#   #.......#
               #....##.#   #....##/#
               #/##/##/#   #/##/##/###
            ####/##/##/#####/##/##***##
            #..............!....//****#
            #/#%%%%%%%%%%%%%%%%%##****#
            #/#%%%%%%%%%%%%%%%%%##****#
            #*******************//****#
            #/###/#%###%###/##**##****#
             /  #.#       #.##**//****#
    #%#####  /  #.#       #.###/##****#
    #..//.#  /  ###       ### #/##****#
    #/###.# #/##   #%##%#     #.//****#
    #/###.###..#   #....#     #.##****#
    #........../////..0.///////.//****#
    ###.....##/#   #/##/#     ####/####
      ##....##/#####/##/##########/##
       #....##.......//.......//....##
       ####.//.......##.......##.....#
          ####.......##.......//.....#
             #.......//.......##.....#
             #.......##.......//.....#
             #.......##.......##.....#
            ##.......##.......//.....#
            #........##.......##.....#
           ##.......###.......###....#
           #........# #........##/##/#
           #........///........##/##/#
           #........# ##.......//....#
           ####/%%%/#  ###/#%#/###%#%#
               /   /      /   /
               /   /      /   /
               /   /      /   /
               /   /      /   /
               /   /      /   /
              #/%%%/#    #/%%%/#
              #.....#    #.....#
             ##.....#    #.....#
             #......#    #.....#
             ########    #######