            ##########
########    #........#
#......#    #........#    ######
#..0...#    #....?...#    #.!..#       
#......//////........//////....#
###/####    #........#    #..!.#
###/####    #.....?..#    ####/#
#......#    #........#        /
#......#    #........#        /
#......//////........#    ####/#
#......#    #....?...//////....#
#...!..#    #........#    ###/##
#......#    #####/####       /
#####/##    #####/####       /
     /      #...!....#    ###/###
     /      ####/#####    #.!...#
     /          /         #...!.#
     /          /         ###/###
    #/##    ####/####        /
    #..//////...!...#     ###/###
    #!.#    #.......///////..!..#
    ####    #########     #######