###########$######################$########
#****************************/A!!!!!!!!!!!#
#/######################ab#**/B!!!!!!!!!!!#
 /                        #***#!!!!!!!!!!!#
#0#                       ####$!!!!!!!!!!!#
#*#                          ####$#########
 #









