###########$######################$########
#*0********.*******************???.??????!#
#/#########################****!!!!!!!!!!!#
 /                        #***#!!!!?????!!#
#.#                       #####!!.!!!!!!!!#
#.#                          ####$#########
 #









