            ##########
########    #........#
#......#    #........#    ######
#..0...#    #........#    #....#       
#......//////........//////....#
###/####    #........#    #....#
###/####    #........#    ####/#
#......#    #........#        /
#......#    #........#        /
#......//////........#    ####/#
#......#    #........//////....#
#......#    #........#    ###/##
#......#    #####/####       /
#####/##    #####/####       /
     /      #...!....#    ###/###
     /      ####/#####    #.....#
     /          /         #.....#
     /          /         ###/###
    #/##    ####/####        /
    #..//////.......#     ###/###
    #..#    #.......///////.....#
    ####    #########     #######