     #####
     #.!.#
     #...#
     #...#
     ##/##
       /
       /
       /
       /
       /
       /
       /
     ##/##
#### #...# ####
#!.|//...//|.!#
#### ##/## ####
       /
       /
       /
       /
       /
       /
    ###|###
    #.....#
    #..0..#
    #.....#
    #######
