  #$#$#$#
  #!!*!!#
  #!!*!!#
  #!!*!!#
   ##/##
   ##/##
   #.0.#
   ##/##
#####/#####
#.........#
#.........#
#.........#
#.........#
#.........#
#.........#
###########