            ##%#%##
            #*****#
            #*****#
            #*****#
            #*****#
            #*****#
##%##       ###/###       ##%##
#...#         #/#         #...#
#...///////////.///////////...#
#...#         #/#         #...#
#...#        ##/##        #...#
#...#        #***#        #...#
#...#        #***#        #...#
#...#        #***#        #...#
#...#        ##/##        #...#
#...#          /          #...#
#.!.#       ###/###       #.!.#
##%##       #.....#       ##%##
            #.....#
            #..0..#
            #.....#
            #.....#
            ##%#%##