                    #####
                    #***#
                    #*0*#
                    #***#
                    ##/##
          ############/############
          #***##...##***##...##***#
          #***//...//***//...//***#
          #***##...##***##...##***#
          ##/####/####/####/####/##
          ##/####/####/####/####/##
          #...##***##...##***##...#
          #...//***##...##***//...#
          #...##***##...##***##...#
          ##/####/####/####/####/##
          ##/####/### / ###/####/##
          #...##....# / #....##...#
          #...##.!..# / #..!.##...#
          #.!.##....# / #....##.!.#
          ######....# / #....######
               ####/# / #/####
                   /  /  /
                  #/##/##/#
                  #.##.##.#
                  #.##!//.#
                  #.//.##.#
                  #########