     #######    #####    #######
     #.....//////...//////.....#
     #.....#    #.!.#    #.....#
     #.....#    #####    #.....#
     #.....#             #.....#
     #.....#             #.....#
     #.....# ########### #.....#
     #.....///.........///.....#
     #.....# #.........# #.....#
     ####### #.........# ###/###
             #####/#####    /
#####         ### /         /
#!..#         #.##/#        /
#!..///////////.//0#        /
#!..#         ####/#        /
#####         ####/#########/###
              #................#
              #................#
              #................#
              #................#
              #................#
              #................#
              #................#
              #................#
              ##################