             #######
             #.....#
             #.!.!.#
             ##/#/##
  ############ / / ############
  #....##....##|#|##....##....#
  #..!.//....//...//....//.!..#
  #....##/#..##.0.##..#/##....#
  #....# /#..##...##..#/ #....#
  #....# /##/###A###/##/ #....#
  #....# /  /   /   /  / #....#
  #....# /  / ##B## /  / #....#
  #....##/##/##...##/##/##....#
  #....//.##.//...//.##.//....#
  #############...#############
              #a#b#