
 #####  #####     #####  #####
 #...#  #...#     #...#  #...#
 #.!.////.!.#     #.!.////.!.#
 #...#  #...#     #...#  #...#
 ## ##  ##/##     ##/##  #####
          /         /      
          /         /      
 #####  ##/##     ##/##  #####
 #...#  #...#     #...#  #...#
 #.!.////.!.#     #.!.////.!.#
 #...#  #...#     #...#  #...#
 ##/##  #####     #####  ##/##
   /                       /
   /                       /
 ##/##  #####     #####  ##/##
 #...#  #...#  #  #...#  #...#
 #.!.////...///.///...////.!.#
 #...#  #...#  /  #...#  #...#
 #####  #####  /  #####  #####
               /  
            ###/###
            #.....#
            #.....#
            #..0..#
            #.....#
            #.....#
            ##%#%##
