            ##########
########    #........#
#......#    #........#    ####%####
#......#    #........#    #.......#     
#......//////......../////N..0...?#
###/####    #...^....#    #....####
   /        #........#    #....#
###/####    #........#    #n##/#
#......#    #........#        /
#......#    #........#        /
#......//////........#    ####/#
#......#    #........//////....#
#......#    #........#    ###/##
#......#    #####/####       /
#......#         /           /
#####/##    #####/####       /
     /      #...!....#    ###/###
     /      ####/#####    #.....#
     /          /         #.....#
     /          /         ###/###
    #/##    ####/####        /
    #..//////.......#     ###/###
    #..#    #.......///////.....#
    ####    #########     #######