#########    #######
#.......//////.....#
#.......#    #.....#
#.......#    #.....#
###/###/#    #.....#
###/# #/###  #.....#
#...# #...////.....#
#..?# #...#  #.....#
#...# #...#  #.....#
#/### ###/#  #####/#
 /       /        /
 /       /        /
#/#######/#  #####/##
#......//.////......#
#......##/#  #......#
#......# /   #......#
#......# /   ###....#
#......##/#### #....#
#......##....# #....#
#......##..0.///.?..#
#......##....# #....#
#..#########/# ####/#
#..#        /     #/#
#..#        /     #.#
#..# #######/###  #/#
#..///.//......####/#
#### ####..?...##...#
#########......//...#
#...//.//......##...#
#...#############...#
#...#           #...#
#...#           #...#
#..?#  ######## #...#
#...#  #......///...#
#...////......# #...#
#####  ######## #####