        ##%##%##%##
        #.........#
        #.........#
        #.........#
        #.........#
        #....!....#
        #.........#
        #.........#
        #.........#
        #.........#
        #####/#####
             /
             /
             /
  ##### #####/##### #####
  #...# #.........# #...#
  #.!.///....0....///.!.#
  #...# #.........# #...#
  ##### ########### #####