##### ###
#!!!///.#
##/## #/#
##Aa# #/#
#.0.///.#
##### ###