######################
#....................#
#..S.................#                #####################
#....................#                #...................#
#....................//////////////////...................#
#....................#                #...................#
#....................#                #...................#
#....................#                #...................#
#/####################                #### ################
 /
 /
 /
 /
 /
 /
 /
 /
 /
 /
 /
#/####################
#....................#
#....................#
#....................#
#....................#
#....................#
######################