 										######################### 			
          #######						#.......................#						
          #.....#		###########		#.......................#	
          #.....#		#.........///////.......................#
          #...../////////.....!...#		#.......................#	
          #.....#		#####/#####		#.......................#
          #.....#			 /			#.......................#
          #/#####			 /			#.......................#
           /				 /			#.......................#
           /		    #####/###	    #.......................#
           /			#.......#		#.......................#
           /			#...?...#		#.......................#
      	###/#########	#.......# 		############/############
      	#...........#	#####/### 					/
      	#...........#		 /						/
      	#...........#		#/#######			####/####
      	#......0....#		#.......#			#.......#
      	#...........#		#.......#			#.......#
      	#...........////////#.......#///////////#.......#	
      	#############		#.......#			#...?...#
      						#.......#			#.......#
      						#########			#.......#
      											#.......#	
      											#########