           #####
           #...#
           #.!.#
           #...#
           ##/##
            #/#
            #.#
            #/#
        #####/#####
        #.........#
        #.........#
#####   #.........#   #####
#...#####.........#####...#
#.!.//.//....!....//.//.0.#
#...#####.........#####...#
#####   #.........#   #####
        #.........#
        #.........#
        #####/#####
            #/#
            #.#
            #/#
           ##/##
           #...#
           #.!.#
           #...#
           #####