########    ##########
#......#    #........#
#..S...#    #........#                #####################
#......#    #........#                #...................#
#......//////........//////////////////...................#
#......#    #........#                #...................#
#......#    #........#                #...................#
#......#    #........#                #...................#
#/######    #/########                ####/################
 /           /                            /
 /           /                            /
 /           /            ########      ##/#####
 /       ####/##          #......#      #......#
 /       #.....////////////......////////......#
 /       #.....#          #......#      #...*..#
 /       #..*..#          ###/####      ########
 /       #.....#             /
 /       #.....#             /
 /       ###/###             /
 /          /                /
#/##########/#########     ##/###
#....................#     #....#
#....................#     #..*.#
#....................///////....#
#....................#     #....#
#....................#     ######
######################