
  ####  #####     #####  ####
  #!.////.!.#     #.!.////.!#
  #..#  #...#     #...#  #..#
  ####  ##/##     ##/##  ####
          /         /      
          /         /      
  ####  ##/##     ##/##  ####
  #..#  #...#     #...#  #..#
  #!.////.!.#     #.!.////.!#
  #..#  #...#     #...#  #..#
  #/##  #####     #####  ##/#
   /                       /
   /                       /
  #/##  ###############  ##/#
  #..#  #...##...##...#  #..#
  #!.////...//...//...////.!#
  ####  #######/#######  ####
               /
               /
            ###/###
            #..0..#
            #.....#
            #.....#
            #.....#
            #.....#
            ##%#%##
