             #########
  ######     #.......#    ######
  #....///////.......//////....#
  #....#     ####/####    #....#
  #....#         /        #....#
  #....#     ####/####    #....#
  #....///////.......//////....#
  ###/##     #.......#    ##/### 
     /       ####/####      /
  ###/##         /        ##/###
  #....#       ##/##      #....#
  #....#       #...#      #.?..#
  #..../////////...#      #....#
  #/####       #...#      #....#
   /           ##/##      #....#
   /             /        #....#
   /           ##/##      #....#
  #/####       #...#      #....#
  #..../////////.0.////////..!.#
  #?...#       #...#      #....#
  ######       #####      ######