                                                         #
                                                         
               ######         ######                     
               #.//.#         #.//.#                    
               #/##/#         #/##/#######                
                /  /           /  / #****#                        
            ####/##/###########/##/##****#                                       
            #.//...................//****#                
            #.##...................##****#                
            #.###/#/#######/#/##/#/##****#             
            #####/#/#######/#/##/#/##****#                                       
            #*****************##...##****#                                         
    ####    #/#####/#######/####...##****#                     
    #**###   /  #.#       #.#  #...##****#
    #**/.#   /  ###       ###  #...##****#                         
    #/##.#  #/##               #...##****#                         
    #/##/####..#    #####      #...##****#                              
    #.//...##../////..0.///////#...##****#                                 
    #####/####/#####/##/##########/##/####                      
        #/####.......##.......//......#                        
        #...//.......//.......##......#                                     
        ######.......##.......##......#                        
             #.......##.......##......#                          
             #.......##.......##......#                         
                     ##                                  
                     ##                                  
                     ##                                  
                                                         
                                                         
                                                         
                                                         
                                                         
                                                         
                                                         
                                                         
                                                         
                                                         
                                                         
                                                         
                                                         
                                                         
                                                         
                                                         