
               ######         ######
               #.//.#         #.//.#
               #/##/#         #/##/#
            ####/##/###########/##/####
            #.//................//****#
            #/##/#/#/#/#/#/###/###****#
            #/##/#/#/#/#/#/###/###****#
            #***************//**//****#
            #/###/#########/##**##****#
   #####     /  #.#       #.##**//****#
   #***# ### /  #.#       #.###/##****#
   #***///.# /  ###       ### #/##****#
   ##/## #/##/##   ######     #.//****#
    #/####/##..#   #....#     #.##****#
    #.//...//../////..0.///////.//****#
    ####...###/#   #/##/#     ####/#/##
       #...# #/#####/##/##########/#/#
       #...///.//....//.......//.....#
       ##### #.#####/##.......##.....#
             #.#    / #.......//.....#
             #.#  ##/##.......##.....#
             #.////..##.......//.....#
             #/#  #/###.......##.....#
            ##/####/# #.......//.....#
            #.......# #.......##.....#
            #.......# #.......###/##/#
            #.......# #.......# #/##/#
            #.......///.......# #****#
            #.......# #.......///****#
            ##/###/## ###/###/# ######
              /   /      /   /
              /   /      /   /
              /   /      /   /
              /   /      /   /
              /   /      /   /
             #/###/#    #/###/#
             #.....#    #.....#
          ####.....#    #.....#
          #.//.....#    #.....#
          ##########    #######