         ####x#
  ########...!#
  #!....//....#
  #.....##/##X#
  #!....# / #/#b#
  ####B## / #...#
      /   / ##/##
######/# #A#a#/#
#..//..# #.....#
#!.##..//Z..0..#
#.!##..# #.....#
#####..# ####z##
    ####
