######################
#....................#
#..S.................#
#....................#
#....................//////////////////
#....................#
#....................#
#....................#
#/####################
 /
 /
 /
 /
 /
 /
 /
 /
 /
 /
 /
#/####################
#....................#
#....................#
#....................#
#....................#
#....................#
######################