     ######
     #!***#
     #****#    
     ####/#    ####
         /     #*!#
         /     #**#
### ###a#A###  #**#
#*///.......///|**#
#*# #.......#  #**#
#*# #..0....#  #**#
#*# #.......#  #*!#
#*# #.......#  ####
#*# #.......#
#*# #######/#
#*#    #b##/#
#*#    #****#
#*#    #/####
#*#  ###B#
#*////...#
###  #####