##############
#.....##.....#
#..0..||..!!.#
#.....##.....#
###|######|###
###|######|###
#.....##.....#
#..!!.//.!!..#
#.....##.....#
##############