  #$#$#$#
  #!!.!!#
  #!!.!!#
  #!!.!!#
   ##/##
   ##/##
   #.0.#
   ##/##
#####/#####
#.........#
#.........#
#.........#
#.........#
#.........#
#.........#
###########