          #########################
          #*!*##...##***##...##***#
          #***//...//***//...//*!*#
          #***##...##***##...##***#
          ##/####/####/####/####/##
          ##/####/####/####/####/##
          #...##***##...##***##...#
          #...//***//.0.//***//...#
          #...##***##...##***##...#
          ##/####/####/####/####/##
          ##/####/####/####/####/##
          #***##...##***##...##***#
          #***//...//***//...//***#
          #*!*##...##***##...##*!*#
          #########################