
  ######     #########    ######
  #....#     #.......#    #....#
  #....#     #.......#    #....#
  #....#     #.......#    #....#
  #....///////.......//////....#
  #....#     #.......#    #....#
  ###/##     #.......#    ##/### 
     /       ####/####      /
  ###/##         /        ##/###
  #....#       ##/##      #....#
  #..?.#       #...#      #.!..#
  #..../////////.0.////////....#
  #....#       #...#      #....#
  #....#       ##/##      #....#
  #....#         /        #....#
  #....#       ##/##      #....#
  #....#       #...#      #....#
  #..../////////...////////....#
  #....#       #...#      #....#
  ######       #####      ######