#######$#######
#!..##***##..!#
#...//***//...#
#...##***##...#
##/####/####/##
##/####/####/##
#...##...##...#
#...##.0.##...#
#...##...##...#
##/####/####/##
##/####/####/##
#...##***##...#
#...//***//...#
#!..##***##..!#
#######$#######