###$####    ##########
#......#    #********#
#......#    #********#    ########    #####################
#......#    #********#    #......#    #...................#
#......|/////********//////......//////...................######
#..0...#    #********#    #......#    #...................##...#
#......#    #********#    ####/###    #...................//...#
#......#    #********#        /       #...................######
#B#b####    #/####/###        /       ####/##/#############
 /           /  ##/###        /           /  /
 /           /  #....#        /           /  /
 /           /  ######    ####/###      ##/##/##
 /       ####/##          #******#      #......#
 /       #.....////////////******////////......#
 /       #.....#          #******#      #......#
 /       #.....#          ###/####      ########
 /       #.....#             /
 /       #.....#             /
 /       ##/####             /
 /         /                 /
#/####  ###/##########     ##/###
#....#  #............#     #....#
#....#  #............#     #....#
#....////............#     #....#
#....#  #............///////....#
#....#  #............#     ######
######  ##############