        ##%##%##%##
        #.........#
        #.........#
        #.........#
        #.........#
        #....!....#
        #.........#
        #.........#
        #.........#
        #.........#
        ####/######
            /
            /
  ##### ####/#### #####
  #...# #.......# #...#
  #.!.///...0...///.!.#
  #...# #.......# #...#
  ##### ######### #####