            ##########
########    #........#
#......#    #........#
#..S...#    #........#                
#......//////........#
########    #........#
            #........#
            #........#
            ##########
