###$####    ##########
#......#    #........#
#..!...#    #........#                #####################
#......#    #........#                #...................#
#......|/////........//////////////////...................#
#..0...#    #........#                #...................#
#......#    #........#                #...................#
#.b....#    #........#                #...................#
#B######    #/########                ####/################
 /           /                            /
 /           /                            /
 /           /            ########      ##/#####
 /       ####/##          #......#      #......#
 /       #.....///////////A......////////...!..#
 /       #.....#          #a.....#      #......#
 /       #..!..#          ###/####      ########
 /       #.....#             /
 /       #.....#             /
 /       ###/###             /
 /          /                /
#/##########/#########     ##/###
#....................#     #....#
#....................#     #..!.#
#....................///////....#
#....................#     #....#
#....................#     ######
######################