##########      ######
#.......0#      #...?#
%........|//////#....#
#!.......#      #....#
##########      ######