########    ##########
#......#    #........#
#..S...#    #........#                #####################
#......#    #........#                #...................#
#......//////........//////////////////...................#
#......#    #........#                #...................#
#......#    #........#                #...................#
#......#    #........#                #...................#
#/######    #/########                ####/################
 /           /                            /
 /           /                            /
 /           /            ########      ##/#####
 /       ####/##          #......#      #......#
 /       #.....////////////......////////...!..#
 /       #.....#          #......#      #......#
 /       #..!..#          ###/####      ########
 /       #.....#             /
 /       #.....#             /
 /       ###/###             /
 /          /                /
#/##########/#########     ##/###
#....................#     #....#
#....................#     #..!.#
#....................///////....#
#....................#     #....#
#....................#     ######
######################