#######$#######
#!..##...##..!#
#...//...//...#
#...##...##...#
##/####/####/##
##/####/####/##
#...##...##...#
#...##.0.##...#
#...##...##...#
##/####/####/##
##/####/####/##
#...##...##...#
#...//...//...#
#!..##...##..!#
#######$#######