            ##########
########    #........#
#......#    #........#
#..0...#    #........#                
#......//////........#
########    #........#
            #........#
            #........#
            ##########
