##%### #%#  ###%#
#....///.////...##
#....# #/#  ##...#
#.?.## #/#####...##
#...#  #.0.///....#
#..##  #...# #....#
#..#   ###/# ####/#
#..#      /    ##/#
#.#####   /    #..#
#.# #.####/#   ##/#
#.///.//...##    / 
### ####.?..# ###/#
 #######....///...#
 #.//.//..### #...#
 #.########   #..##
 #.#    ####  #..#
 #?#    #..////..#
 #.//////..#  ##%#
 #%#    ##%# 