######################
#....................#
#..S.................#                #####################
#....................#                #...................#
#..............*.....//////////////////...................#
#....................#                #...................#
#....................#                #...................#
#....................#                #...................#
#/####################                #### ################
 /
 /
 /
 /
 /
 /
 /
 /
 /
 /
 /
#/####################
#....................#
#....................#
#....................////////////////////////*
#....................#
#....................#
######################