##############
#.....##.....#
#..0..||..!..#
#.....##.....#
###|######|###
###|######|###
#.....##.....#
#..!..//..!..#
#.....##.....#
##############