#########
#.......#
#.......#
#.......#
#.......#
#.......#
####/####
    /
    /
    /
 ###/###
 #.....#
 #.....#
 #..0..#
 #.....#
 #.....#
 ###/###
    /
    /
    /
  ##/##
  #...#
  #.!.#
  #...#
  #####