###############
#!..##*!*##..!#
#...//***//...#
#...##***##...#
##/####/####/##
##/####/####/##
#...##...##...#
#...##.0.##...#
#...##...##...#
##/####/####/##
##/####/####/##
#...##***##...#
#...//***//...#
#!..##*!*##..!#
###############