                 #####
                 #...#
                 #.0.#
                 #...#
                 ##/##
        ########## / ##########
        #...##.!.# / #.!.##...#
        #...//...# / #...||...#
        #...##...# / #...##...#
        ##/####|## / ##|####|##
        ##/####|###|###|####|##
        #...##...........##...#
        #!..||...........||..!#
        #...##...........##...#
   ###########...........###########
   #...#     #...........#     #...#
   #!..//////|...........|//////..!#
   #...#     #...........#     #...#
   ###########...........###########
        #...##...........##...#
        #!..||...........||..!#
        #...##...........##...#
        ##|####|###|###|####|##
        ##|####|## / ##|####|##
        #...##...# / #...##...#
        #...||...# / #...||...#
        #...##.!.# / #.!.##...#
        ########## / ##########
                 ##/##
                 #...#
                 #...#
                 #.!.#
                 #####