             #########
  ######     #...!...#    ######
  #....///////.......//////....#
  #....#     ####/####    #....#
  #.!..#         /        #.!..#
  #....#     ####/####    #....#
  #....///////...?...//////....#
  ###/##     #.......#    ##/### 
     /       ####/####      /
  ###/##         /        ##/###
  #....#       ##/##      #....#
  #.!..#       #...#      #.?..#
  #..../////////...#      #....#
  #/####       #...#      #....#
   /           ##/##      #....#
   /             /        #....#
   /           ##/##      #....#
  #/####       #...#      #....#
  #..../////////.0.////////..!.#
  #?...#       #...#      #....#
  ######       #####      ######