                 #####
                 #...#
                 #.0.#
                 #...#
                 ##/##
        ########## / ##########
        #...##.!.# / #.!.##...#
        #...//...# / #...||...#
        #...##...# / #...##...#
        ##/####|## / ##|####|##
        ##/####|###|###|####|##
        #...##***********##...#
        #!..||***********||..!#
        #...##***********##...#
   ###########***********###########
   #...#     #***********#     #...#
   #!..//////|***********|//////..!#
   #...#     #***********#     #...#
   ###########***********###########
        #...##***********##...#
        #!..||***********||..!#
        #...##***********##...#
        ##|####|###|###|####|##
        ##|####|## / ##|####|##
        #...##...# / #...##...#
        #...||...# / #...||...#
        #...##.!.# / #.!.##...#
        ########## / ##########
                 ##/##
                 #...#
                 #...#
                 #.!.#
                 #####