############
#!...##...!#
#....//....#
#....##...!#
####B#######
 #b#|# ###z#
 #***//C...#
 ###/# #...#
  ##/# #/#c#
  #..###A#a##
  #..##.....#
  #..##...0.#
  #..Z/.....#
  #..##.....#
  ###########