####         ####
#!!#         #!!#     
#!*#  ##$##  #*!#
#**////.0.////**#
####  #...#  ####
      ##/##
########/########
#...............#
#...............#
#...............#
#...............#
#...............#
#...............#
#################