##############          ###############           ###############
#............#          #.............#           #.............#
#....!.......////////////............./////////////......!......#
#............#          #.............#           #.............#
##############          #.............#           ###############
                        #.............#
                        #.............#
                        #.............#
                        #.............#
                        #......0......#
                        #.............#
                        #.............#
                        #.............#
                        #.............#
                        #.............#
                        #.............#
                        ###############