               ####%####   ####%####
               #.......#   #.......#
               #....##.#   #....##/#
               #/##/##/#   #/##/##/###
            ####/##/##/#####/##/##***##
            #...................//****#
            #/####################****#
            #/####################****#
            #*******************//****#
            #/###/#%###%###/##**##**!*#
             /  #.#       #.##**//****#
    #%#####  /  #!#       #!###/##****#
    #..//.#  /  ###       ### #/##****#
    #/###.# #/##   #%##%#     #.//****#
    #/###.###..#   #....#     #.##****#
    #........../////..0.///////.//****#
    ###.....##/#   #/##/#     ####/####
      ##....##/#####/##/##########/##
       #....##.......//.......//....##
       ####.//.......##.......##.....#
          ####.......##.......//.....#
             #.......//.......##.....#
             #.......##.......//.....#
             #.......##.......##.....#
            ##.......##.......//.....#
            #...?....##....?..##.....#
           ##.......###.......###....#
           #........# #........##/##/#
           #........///........##/##/#
           #........# ##.......//....#
           ####/%%%/#  ###/#%#/###%#%#
               /   /      /   /
               /   /      /   /
               /   /      /   /
               /   /      /   /
               /   /      /   /
              #/%%%/#    #/%%%/#
              #.....#    #.....#
             ##.....#    #.....#
             #...!..#    #..!..#
             ########    #######