            ##########
########    #........#
#......#    #........#    
#..!...#    #........#         
#......//////........#
###/####    #...?....#    
   /        #........#    
###/####    #........#   
#..0...#    #........#        
#......#    #####/####        
#......#		 /
#......#	  ###/####
#......////////......# 
########	  #..?...# 
			  ########