###x#########z###
#***!***?***!***#
#***************#
###X#%%%%%%%#Z###
###/#%%%%%%%#/###
#...............#
#.......0.......#
#################