                                     #########################
          #######                    #.......................#
          #.....#  ###########       #.......................#
          #.....#  #........./////////.................!.....#
          #.....////.........#       #.......................#
          #.....#  #####/#####       #.......................#
          #!....#       /            #.......................#
          #/#####       /            #...................!...#
           /            /            #................!......#
           /         ###/#####       #.......................#
           /         #*******#       #.......................#
           /         #***?***#       #....!..................#
       ####/######## #*******#       ############/############
       #...........# #####/###                   /
       #...........#      /                      /
       #...........#  ####/####                ##/######
       #......0....#  #*******#                #.......#
       #...........#  #*******#                #....!..#
       #...........////****?**//////////////////.......#
       #############  #*******#                #.......#
                      #***!***#                #.......#
                      #########                #...!...#
                                               #.......# 
                                               #########