       #########
      ##..##...#   ########
      #........#   #!###**#
     ##.......##   #*###**#         ###     ###         ####    ###
    ##........#    #!###**#     ### #*#     #*#      #####!*/////*#
   ##........##    #*##**#####  #*# #*# ### #*# ###  #*#####    #*#
  ##........##     #/##/## #*////*# #*# #0# #*# #*////*#      ###*#
 ##.........####   #/##/#  #/#  #*# #*# #*# #*# #/#  #*#    ###***#
 #.............### #****#   /   #*# #*# #*# #*#  /   #*#   ##***###
##...............# #/##*##  /   #/# #*# #*# #*#  /   #/#   #**###
#...............##  / #**###/####/###*# #*# #*# #/####/####**# ####
#/##...........##   / #***//*******//*///*///*///*******//**////*!#
#/############/#    / ###/########/#### ### ### #######/########/##
#/############/#####/####/########/####################/########/##
#*****************************************************************#
###################################################################


